{
    "maze": [
        [0, 0, 0, 0, 0],
        [0, 1, 1, 0, 0],
        [0, 0, 1, 0, 0],
        [0, 0, 1, 1, 1],
        [0, 0, 0, 0, 0],
        [0, 1, 1, 0, 0],
        [0, 1, 1, 1, 0],
        [0, 0, 0, 1, 0],
        [0, 1, 1, 1, 0],
        [0, 0, 0, 0, 0]
    ],

    "start": [3,0],
    "end": [9,4]
}