{
    "maze1": [
        [0, 0, 0, 0, 0],
        [0, 1, 1, 0, 0],
        [0, 0, 1, 0, 0],
        [0, 0, 1, 1, 1],
        [0, 0, 0, 0, 0],
        [0, 1, 1, 0, 0],
        [0, 1, 1, 1, 0],
        [0, 0, 0, 1, 0],
        [0, 1, 1, 1, 0],
        [0, 0, 0, 0, 0]
    ],
    

    "start1": [0,2],
    "end1": [9,4],

    "maze2" : [
        [0, 1, 0, 0, 0],
        [0, 1, 0, 1, 0],
        [0, 1, 0, 1, 0],
        [0, 1, 0, 1, 0],
        [0, 0, 0, 0, 0],
        [0, 1, 1, 1, 0],
        [0, 1, 0, 0, 0],
        [0, 1, 0, 1, 0],
        [0, 0, 0, 1, 0],
        [0, 0, 0, 0, 0]
    ],
    
    "start2": [0,0],
    "end2": [0,4],

    "maze3" : [
        [0, 1, 0, 0, 0],
        [0, 1, 0, 1, 0],
        [0, 1, 0, 1, 0],
        [0, 1, 0, 1, 1],
        [0, 0, 0, 0, 0],
        [0, 1, 1, 1, 0],
        [1, 1, 0, 0, 0],
        [1, 1, 0, 1, 0],
        [0, 0, 0, 1, 0],
        [1, 1, 1, 1, 0]
    ],

    "start3": [0,0],
    "end3": [6,2],

    "maze4": [
        [0,1,1,1,0],
        [0,0,1,0,1],
        [1,0,0,0,1],
        [1,1,1,0,1],
        [0,0,0,0,1]
    ],

    "start4": [1,0],
    "end4": [4,0]

}