{
    "dfs_best_maze": [
        [0, 0, 0, 0, 0],
        [0, 1, 1, 0, 0],
        [0, 0, 1, 0, 0],
        [0, 0, 1, 1, 1],
        [0, 0, 0, 0, 0],
        [0, 1, 1, 0, 0],
        [0, 1, 1, 1, 0],
        [0, 0, 0, 1, 0],
        [0, 1, 1, 1, 0],
        [0, 0, 0, 0, 0]
    ],
    

    "dfs_start": [0,0],
    "dfs_end": [9,4],

    "bfs_best_maze" : [
        [0, 1, 0, 0, 0],
        [0, 1, 0, 1, 0],
        [0, 1, 0, 1, 0],
        [0, 1, 0, 1, 0],
        [0, 0, 0, 0, 0],
        [0, 1, 1, 1, 0],
        [0, 1, 0, 0, 0],
        [0, 1, 0, 1, 0],
        [0, 0, 0, 1, 0],
        [0, 0, 0, 0, 0]
    ],
    
    "bfs_start": [0,0],
    "bfs_end": [0,4]
    
}